ImageFile,BitSequenceFile,Payload,BitSequenceLength,OriginalBitChange,OptimizedBitChange,OptimizedNum,TimeTaken
yagate_gs.png,bit_sequence_payload-0-0.txt,0,0,0,0,0,0.009001732
yagate_gs.png,bit_sequence_payload-0-1.txt,0,0,0,0,0,0.009999037
yagate_gs.png,bit_sequence_payload-0-10.txt,0,0,0,0,0,0.006008148
yagate_gs.png,bit_sequence_payload-0-11.txt,0,0,0,0,0,0.004999876
yagate_gs.png,bit_sequence_payload-0-12.txt,0,0,0,0,0,0.004505634
yagate_gs.png,bit_sequence_payload-0-13.txt,0,0,0,0,0,0.005003214
yagate_gs.png,bit_sequence_payload-0-14.txt,0,0,0,0,0,0.004997253
yagate_gs.png,bit_sequence_payload-0-15.txt,0,0,0,0,0,0.003994942
yagate_gs.png,bit_sequence_payload-0-16.txt,0,0,0,0,0,0.004000425
yagate_gs.png,bit_sequence_payload-0-17.txt,0,0,0,0,0,0.002001286
yagate_gs.png,bit_sequence_payload-0-18.txt,0,0,0,0,0,0.004000664
yagate_gs.png,bit_sequence_payload-0-19.txt,0,0,0,0,0,0.002999544
yagate_gs.png,bit_sequence_payload-0-2.txt,0,0,0,0,0,0.005001068
yagate_gs.png,bit_sequence_payload-0-3.txt,0,0,0,0,0,0.007000208
yagate_gs.png,bit_sequence_payload-0-4.txt,0,0,0,0,0,0.004000425
yagate_gs.png,bit_sequence_payload-0-5.txt,0,0,0,0,0,0.007000923
yagate_gs.png,bit_sequence_payload-0-6.txt,0,0,0,0,0,0.003998756
yagate_gs.png,bit_sequence_payload-0-7.txt,0,0,0,0,0,0.00399971
yagate_gs.png,bit_sequence_payload-0-8.txt,0,0,0,0,0,0.004975796
yagate_gs.png,bit_sequence_payload-0-9.txt,0,0,0,0,0,0.003999949
yagate_gs.png,bit_sequence_payload-1-0.txt,1,40,17,12,5,0.114207029
yagate_gs.png,bit_sequence_payload-1-1.txt,1,40,24,12,12,0.053014755
yagate_gs.png,bit_sequence_payload-1-10.txt,1,40,16,11,5,0.034999609
yagate_gs.png,bit_sequence_payload-1-11.txt,1,40,25,13,12,0.047005415
yagate_gs.png,bit_sequence_payload-1-12.txt,1,40,17,12,5,0.0345819
yagate_gs.png,bit_sequence_payload-1-13.txt,1,40,16,12,4,0.031999111
yagate_gs.png,bit_sequence_payload-1-14.txt,1,40,17,12,5,0.048442602
yagate_gs.png,bit_sequence_payload-1-15.txt,1,40,23,14,9,0.072947979
yagate_gs.png,bit_sequence_payload-1-16.txt,1,40,16,12,4,0.040323019
yagate_gs.png,bit_sequence_payload-1-17.txt,1,40,15,13,2,0.051034451
yagate_gs.png,bit_sequence_payload-1-18.txt,1,40,25,10,15,0.03825736
yagate_gs.png,bit_sequence_payload-1-19.txt,1,40,22,14,8,0.097532511
yagate_gs.png,bit_sequence_payload-1-2.txt,1,40,16,12,4,0.045166492
yagate_gs.png,bit_sequence_payload-1-3.txt,1,40,25,13,12,0.050580263
yagate_gs.png,bit_sequence_payload-1-4.txt,1,40,17,13,4,0.059085369
yagate_gs.png,bit_sequence_payload-1-5.txt,1,40,17,9,8,0.034280777
yagate_gs.png,bit_sequence_payload-1-6.txt,1,40,10,13,-3,0.03858304
yagate_gs.png,bit_sequence_payload-1-7.txt,1,40,21,13,8,0.063610554
yagate_gs.png,bit_sequence_payload-1-8.txt,1,40,18,8,10,0.029246569
yagate_gs.png,bit_sequence_payload-1-9.txt,1,40,20,13,7,0.049981117
yagate_gs.png,bit_sequence_payload-2-0.txt,2,81,45,28,17,0.155533791
yagate_gs.png,bit_sequence_payload-2-1.txt,2,81,45,30,15,0.125688791
yagate_gs.png,bit_sequence_payload-2-10.txt,2,81,46,31,15,0.159061193
yagate_gs.png,bit_sequence_payload-2-11.txt,2,81,34,29,5,0.157516241
yagate_gs.png,bit_sequence_payload-2-12.txt,2,81,41,28,13,0.176111221
yagate_gs.png,bit_sequence_payload-2-13.txt,2,81,52,31,21,0.586153507
yagate_gs.png,bit_sequence_payload-2-14.txt,2,81,40,27,13,0.15906167
yagate_gs.png,bit_sequence_payload-2-15.txt,2,81,39,28,11,0.11851573
yagate_gs.png,bit_sequence_payload-2-16.txt,2,81,38,27,11,0.144265413
yagate_gs.png,bit_sequence_payload-2-17.txt,2,81,34,29,5,0.161616325
yagate_gs.png,bit_sequence_payload-2-18.txt,2,81,43,30,13,0.194800138
yagate_gs.png,bit_sequence_payload-2-19.txt,2,81,45,32,13,0.258878469
yagate_gs.png,bit_sequence_payload-2-2.txt,2,81,39,26,13,0.151888847
yagate_gs.png,bit_sequence_payload-2-3.txt,2,81,43,28,15,0.214956522
yagate_gs.png,bit_sequence_payload-2-4.txt,2,81,45,26,19,0.187072039
yagate_gs.png,bit_sequence_payload-2-5.txt,2,81,48,29,19,0.226721525
yagate_gs.png,bit_sequence_payload-2-6.txt,2,81,44,27,17,0.216048479
yagate_gs.png,bit_sequence_payload-2-7.txt,2,81,47,30,17,0.191202164
yagate_gs.png,bit_sequence_payload-2-8.txt,2,81,38,27,11,0.17152524
yagate_gs.png,bit_sequence_payload-2-9.txt,2,81,48,29,19,0.264121056
yagate_gs.png,bit_sequence_payload-3-0.txt,3,122,58,41,17,0.290045738
yagate_gs.png,bit_sequence_payload-3-1.txt,3,122,66,45,21,1.195261955
yagate_gs.png,bit_sequence_payload-3-10.txt,3,122,66,41,25,0.335158825
yagate_gs.png,bit_sequence_payload-3-11.txt,3,122,65,40,25,0.517758608
yagate_gs.png,bit_sequence_payload-3-12.txt,3,122,66,43,23,0.627552748
yagate_gs.png,bit_sequence_payload-3-13.txt,3,122,56,45,11,0.304260731
yagate_gs.png,bit_sequence_payload-3-14.txt,3,122,61,44,17,0.401299953
yagate_gs.png,bit_sequence_payload-3-15.txt,3,122,66,47,19,0.535487652
yagate_gs.png,bit_sequence_payload-3-16.txt,3,122,55,42,13,0.419160604
yagate_gs.png,bit_sequence_payload-3-17.txt,3,122,58,43,15,0.41227603
yagate_gs.png,bit_sequence_payload-3-18.txt,3,122,57,44,13,0.628228903
yagate_gs.png,bit_sequence_payload-3-19.txt,3,122,63,44,19,0.553205252
yagate_gs.png,bit_sequence_payload-3-2.txt,3,122,55,44,11,0.494678259
yagate_gs.png,bit_sequence_payload-3-3.txt,3,122,70,43,27,0.557649374
yagate_gs.png,bit_sequence_payload-3-4.txt,3,122,54,41,13,0.324631453
yagate_gs.png,bit_sequence_payload-3-5.txt,3,122,56,45,11,0.294589758
yagate_gs.png,bit_sequence_payload-3-6.txt,3,122,60,43,17,0.333340168
yagate_gs.png,bit_sequence_payload-3-7.txt,3,122,70,45,25,0.345767736
yagate_gs.png,bit_sequence_payload-3-8.txt,3,122,61,42,19,0.326750755
yagate_gs.png,bit_sequence_payload-3-9.txt,3,122,57,46,11,0.305603504
yagate_gs.png,bit_sequence_payload-4-0.txt,4,163,80,52,28,1.664054155
yagate_gs.png,bit_sequence_payload-4-1.txt,4,163,70,54,16,0.433058262
yagate_gs.png,bit_sequence_payload-4-10.txt,4,163,72,48,24,0.415206194
yagate_gs.png,bit_sequence_payload-4-11.txt,4,163,74,54,20,1.987871647
yagate_gs.png,bit_sequence_payload-4-12.txt,4,163,69,49,20,0.331101894
yagate_gs.png,bit_sequence_payload-4-13.txt,4,163,76,53,23,0.539978743
yagate_gs.png,bit_sequence_payload-4-14.txt,4,163,60,50,10,0.29564023
yagate_gs.png,bit_sequence_payload-4-15.txt,4,163,70,52,18,1.717885256
yagate_gs.png,bit_sequence_payload-4-16.txt,4,163,70,50,20,1.37084794
yagate_gs.png,bit_sequence_payload-4-17.txt,4,163,71,50,21,1.362803221
yagate_gs.png,bit_sequence_payload-4-18.txt,4,163,71,52,19,0.7591784
yagate_gs.png,bit_sequence_payload-4-19.txt,4,163,76,52,24,1.629354954
yagate_gs.png,bit_sequence_payload-4-2.txt,4,163,70,49,21,0.45562768
yagate_gs.png,bit_sequence_payload-4-3.txt,4,163,74,45,29,0.872200251
yagate_gs.png,bit_sequence_payload-4-4.txt,4,163,79,52,27,1.77319479
yagate_gs.png,bit_sequence_payload-4-5.txt,4,163,72,53,19,0.798244238
yagate_gs.png,bit_sequence_payload-4-6.txt,4,163,80,53,27,0.546653509
yagate_gs.png,bit_sequence_payload-4-7.txt,4,163,68,51,17,0.948766708
yagate_gs.png,bit_sequence_payload-4-8.txt,4,163,89,47,42,1.510808468
yagate_gs.png,bit_sequence_payload-4-9.txt,4,163,71,43,28,0.685127974
yagate_gs.png,bit_sequence_payload-5-0.txt,5,204,104,72,32,4.229609251
yagate_gs.png,bit_sequence_payload-5-1.txt,5,204,106,71,35,4.489087582
yagate_gs.png,bit_sequence_payload-5-10.txt,5,204,110,73,37,4.465995312
yagate_gs.png,bit_sequence_payload-5-11.txt,5,204,102,72,30,3.714056015
yagate_gs.png,bit_sequence_payload-5-12.txt,5,204,100,70,30,2.921629429
yagate_gs.png,bit_sequence_payload-5-13.txt,5,204,99,70,29,3.012516737
yagate_gs.png,bit_sequence_payload-5-14.txt,5,204,99,72,27,4.167321205
yagate_gs.png,bit_sequence_payload-5-15.txt,5,204,93,68,25,3.041423559
yagate_gs.png,bit_sequence_payload-5-16.txt,5,204,108,69,39,3.440737247
yagate_gs.png,bit_sequence_payload-5-17.txt,5,204,90,72,18,2.346410751
yagate_gs.png,bit_sequence_payload-5-18.txt,5,204,102,73,29,4.04561758
yagate_gs.png,bit_sequence_payload-5-19.txt,5,204,113,74,39,4.748210907
yagate_gs.png,bit_sequence_payload-5-2.txt,5,204,99,74,25,3.937112093
yagate_gs.png,bit_sequence_payload-5-3.txt,5,204,94,74,20,4.786087275
yagate_gs.png,bit_sequence_payload-5-4.txt,5,204,112,72,40,4.363011122
yagate_gs.png,bit_sequence_payload-5-5.txt,5,204,88,72,16,1.853970289
yagate_gs.png,bit_sequence_payload-5-6.txt,5,204,98,72,26,3.725543737
yagate_gs.png,bit_sequence_payload-5-7.txt,5,204,97,71,26,3.511314392
yagate_gs.png,bit_sequence_payload-5-8.txt,5,204,97,74,23,5.472886324
yagate_gs.png,bit_sequence_payload-5-9.txt,5,204,84,73,11,3.938677788
yagate_gs.png,bit_sequence_payload-6-0.txt,6,245,109,83,26,2.146898746
yagate_gs.png,bit_sequence_payload-6-1.txt,6,245,128,84,44,6.74168992
yagate_gs.png,bit_sequence_payload-6-10.txt,6,245,117,83,34,3.506865501
yagate_gs.png,bit_sequence_payload-6-11.txt,6,245,124,86,38,11.12891436
yagate_gs.png,bit_sequence_payload-6-12.txt,6,245,107,85,22,7.256409645
yagate_gs.png,bit_sequence_payload-6-13.txt,6,245,111,79,32,5.220642328
yagate_gs.png,bit_sequence_payload-6-14.txt,6,245,120,84,36,7.256487608
yagate_gs.png,bit_sequence_payload-6-15.txt,6,245,97,81,16,6.192077637
yagate_gs.png,bit_sequence_payload-6-16.txt,6,245,120,84,36,6.368951797
yagate_gs.png,bit_sequence_payload-6-17.txt,6,245,104,84,20,5.794715643
yagate_gs.png,bit_sequence_payload-6-18.txt,6,245,120,84,36,6.604107141
yagate_gs.png,bit_sequence_payload-6-19.txt,6,245,94,82,12,2.185104847
yagate_gs.png,bit_sequence_payload-6-2.txt,6,245,104,82,22,5.677692413
yagate_gs.png,bit_sequence_payload-6-3.txt,6,245,113,85,28,8.059156656
yagate_gs.png,bit_sequence_payload-6-4.txt,6,245,123,83,40,6.073766708
yagate_gs.png,bit_sequence_payload-6-5.txt,6,245,100,82,18,6.87614727
yagate_gs.png,bit_sequence_payload-6-6.txt,6,245,112,86,26,7.380679369
yagate_gs.png,bit_sequence_payload-6-7.txt,6,245,104,84,20,7.804786205
yagate_gs.png,bit_sequence_payload-6-8.txt,6,245,126,80,46,6.588308573
yagate_gs.png,bit_sequence_payload-6-9.txt,6,245,118,78,40,4.058498383
yagate_gs.png,bit_sequence_payload-7-0.txt,7,286,134,96,38,13.27428842
yagate_gs.png,bit_sequence_payload-7-1.txt,7,286,135,100,35,19.16260695
yagate_gs.png,bit_sequence_payload-7-10.txt,7,286,125,95,30,13.84391022
yagate_gs.png,bit_sequence_payload-7-11.txt,7,286,136,95,41,14.47750545
yagate_gs.png,bit_sequence_payload-7-12.txt,7,286,143,92,51,8.558039188
yagate_gs.png,bit_sequence_payload-7-13.txt,7,286,133,94,39,11.12628412
yagate_gs.png,bit_sequence_payload-7-14.txt,7,286,118,98,20,13.36468577
yagate_gs.png,bit_sequence_payload-7-15.txt,7,286,137,98,39,14.52952766
yagate_gs.png,bit_sequence_payload-7-16.txt,7,286,121,94,27,12.30554247
yagate_gs.png,bit_sequence_payload-7-17.txt,7,286,130,94,36,5.568339586
yagate_gs.png,bit_sequence_payload-7-18.txt,7,286,124,97,27,21.455796
yagate_gs.png,bit_sequence_payload-7-19.txt,7,286,133,97,36,18.07458925
yagate_gs.png,bit_sequence_payload-7-2.txt,7,286,129,96,33,16.80665946
yagate_gs.png,bit_sequence_payload-7-3.txt,7,286,120,96,24,16.34804893
yagate_gs.png,bit_sequence_payload-7-4.txt,7,286,135,95,40,12.55598593
yagate_gs.png,bit_sequence_payload-7-5.txt,7,286,122,99,23,15.05909133
yagate_gs.png,bit_sequence_payload-7-6.txt,7,286,125,96,29,10.80973577
yagate_gs.png,bit_sequence_payload-7-7.txt,7,286,128,98,30,17.13629341
yagate_gs.png,bit_sequence_payload-7-8.txt,7,286,134,97,37,8.308904409
yagate_gs.png,bit_sequence_payload-7-9.txt,7,286,113,99,14,42.35664368
yagate_gs.png,bit_sequence_payload-8-0.txt,8,327,168,120,48,55.37869835
yagate_gs.png,bit_sequence_payload-8-1.txt,8,327,152,118,34,30.95974302
yagate_gs.png,bit_sequence_payload-8-10.txt,8,327,165,122,43,46.35847616
yagate_gs.png,bit_sequence_payload-8-11.txt,8,327,162,121,41,49.83721471
yagate_gs.png,bit_sequence_payload-8-12.txt,8,327,156,126,30,73.00441027
yagate_gs.png,bit_sequence_payload-8-13.txt,8,327,170,122,48,51.8806603
yagate_gs.png,bit_sequence_payload-8-14.txt,8,327,159,126,33,78.94781995
yagate_gs.png,bit_sequence_payload-8-15.txt,8,327,154,119,35,42.30776048
yagate_gs.png,bit_sequence_payload-8-16.txt,8,327,177,122,55,46.97240663
yagate_gs.png,bit_sequence_payload-8-17.txt,8,327,150,123,27,53.18677235
yagate_gs.png,bit_sequence_payload-8-18.txt,8,327,157,125,32,46.19310784
yagate_gs.png,bit_sequence_payload-8-19.txt,8,327,169,120,49,49.62936115
yagate_gs.png,bit_sequence_payload-8-2.txt,8,327,149,123,26,65.50517201
yagate_gs.png,bit_sequence_payload-8-3.txt,8,327,151,126,25,39.33801031
yagate_gs.png,bit_sequence_payload-8-4.txt,8,327,144,121,23,45.47680354
yagate_gs.png,bit_sequence_payload-8-5.txt,8,327,170,122,48,44.42678142
yagate_gs.png,bit_sequence_payload-8-6.txt,8,327,175,125,50,60.90329742
yagate_gs.png,bit_sequence_payload-8-7.txt,8,327,146,125,21,55.65343642
yagate_gs.png,bit_sequence_payload-8-8.txt,8,327,154,121,33,54.97305989
yagate_gs.png,bit_sequence_payload-8-9.txt,8,327,164,124,40,44.51784229
yagate_gs.png,bit_sequence_payload-9-0.txt,9,368,174,139,35,41.83998251
yagate_gs.png,bit_sequence_payload-9-1.txt,9,368,179,136,43,82.13069344
yagate_gs.png,bit_sequence_payload-9-10.txt,9,368,207,132,75,110.740586
yagate_gs.png,bit_sequence_payload-9-11.txt,9,368,161,140,21,56.90736365
yagate_gs.png,bit_sequence_payload-9-12.txt,9,368,181,128,53,34.20850945
yagate_gs.png,bit_sequence_payload-9-13.txt,9,368,186,135,51,17.93051219
yagate_gs.png,bit_sequence_payload-9-14.txt,9,368,189,142,47,39.97103357
yagate_gs.png,bit_sequence_payload-9-15.txt,9,368,179,138,41,60.93414927
yagate_gs.png,bit_sequence_payload-9-16.txt,9,368,179,138,41,37.09921098
yagate_gs.png,bit_sequence_payload-9-17.txt,9,368,190,135,55,59.53961539
yagate_gs.png,bit_sequence_payload-9-18.txt,9,368,165,140,25,30.9793613
yagate_gs.png,bit_sequence_payload-9-19.txt,9,368,202,137,65,137.8914952
yagate_gs.png,bit_sequence_payload-9-2.txt,9,368,171,140,31,61.84640837
yagate_gs.png,bit_sequence_payload-9-3.txt,9,368,165,136,29,83.43297601
yagate_gs.png,bit_sequence_payload-9-4.txt,9,368,187,136,51,73.73708463
yagate_gs.png,bit_sequence_payload-9-5.txt,9,368,180,141,39,53.85823536
yagate_gs.png,bit_sequence_payload-9-6.txt,9,368,192,127,65,36.85174322
yagate_gs.png,bit_sequence_payload-9-7.txt,9,368,198,141,57,33.65533113
yagate_gs.png,bit_sequence_payload-9-8.txt,9,368,173,138,35,57.79291677
yagate_gs.png,bit_sequence_payload-9-9.txt,9,368,179,140,39,182.83446
yagate_gs.png,bit_sequence_payload-10-0.txt,10,409,203,156,47,190.5796349
yagate_gs.png,bit_sequence_payload-10-1.txt,10,409,207,154,53,191.4795985
yagate_gs.png,bit_sequence_payload-10-10.txt,10,409,182,153,29,80.54972553
yagate_gs.png,bit_sequence_payload-10-11.txt,10,409,200,152,48,66.838346
yagate_gs.png,bit_sequence_payload-10-12.txt,10,409,202,155,47,89.6619637
yagate_gs.png,bit_sequence_payload-10-13.txt,10,409,201,148,53,126.7764087
yagate_gs.png,bit_sequence_payload-10-14.txt,10,409,194,147,47,100.6211855
yagate_gs.png,bit_sequence_payload-10-15.txt,10,409,198,147,51,96.87354231
yagate_gs.png,bit_sequence_payload-10-16.txt,10,409,202,150,52,74.186759
yagate_gs.png,bit_sequence_payload-10-17.txt,10,409,197,154,43,85.27573729
yagate_gs.png,bit_sequence_payload-10-18.txt,10,409,193,151,42,77.46479845
yagate_gs.png,bit_sequence_payload-10-19.txt,10,409,190,153,37,82.03157687
yagate_gs.png,bit_sequence_payload-10-2.txt,10,409,225,155,70,195.1643829
yagate_gs.png,bit_sequence_payload-10-3.txt,10,409,186,154,32,160.3753307
yagate_gs.png,bit_sequence_payload-10-4.txt,10,409,213,155,58,201.0036554
yagate_gs.png,bit_sequence_payload-10-5.txt,10,409,188,153,35,61.86051393
yagate_gs.png,bit_sequence_payload-10-6.txt,10,409,197,153,44,70.69525337
yagate_gs.png,bit_sequence_payload-10-7.txt,10,409,214,155,59,85.7774713
yagate_gs.png,bit_sequence_payload-10-8.txt,10,409,174,156,18,82.16227579
yagate_gs.png,bit_sequence_payload-10-9.txt,10,409,189,152,37,70.7231915
yagate_gs.png,bit_sequence_payload-11-0.txt,11,450,220,172,48,105.1856849
yagate_gs.png,bit_sequence_payload-11-1.txt,11,450,211,169,42,177.0275116
yagate_gs.png,bit_sequence_payload-11-10.txt,11,450,218,170,48,107.427218
yagate_gs.png,bit_sequence_payload-11-11.txt,11,450,210,168,42,127.1477039
yagate_gs.png,bit_sequence_payload-11-12.txt,11,450,231,163,68,84.35126019
yagate_gs.png,bit_sequence_payload-11-13.txt,11,450,234,170,64,101.8654149
yagate_gs.png,bit_sequence_payload-11-14.txt,11,450,230,164,66,100.5644879
yagate_gs.png,bit_sequence_payload-11-15.txt,11,450,236,168,68,117.1414757
yagate_gs.png,bit_sequence_payload-11-16.txt,11,450,220,172,48,127.5040236
yagate_gs.png,bit_sequence_payload-11-17.txt,11,450,211,167,44,108.4346862
yagate_gs.png,bit_sequence_payload-11-18.txt,11,450,238,172,66,311.1113827
yagate_gs.png,bit_sequence_payload-11-19.txt,11,450,211,165,46,137.7278299
yagate_gs.png,bit_sequence_payload-11-2.txt,11,450,200,172,28,115.2559767
yagate_gs.png,bit_sequence_payload-11-3.txt,11,450,217,169,48,85.94379187
yagate_gs.png,bit_sequence_payload-11-4.txt,11,450,204,170,34,103.347647
yagate_gs.png,bit_sequence_payload-11-5.txt,11,450,217,169,48,108.8678854
yagate_gs.png,bit_sequence_payload-11-6.txt,11,450,225,163,62,94.37362003
yagate_gs.png,bit_sequence_payload-11-7.txt,11,450,223,167,56,82.45014787
yagate_gs.png,bit_sequence_payload-11-8.txt,11,450,231,171,60,123.7192671
yagate_gs.png,bit_sequence_payload-11-9.txt,11,450,221,165,56,93.30723906
yagate_gs.png,bit_sequence_payload-12-0.txt,12,491,264,185,79,134.5306783
yagate_gs.png,bit_sequence_payload-12-1.txt,12,491,249,185,64,146.9466417
yagate_gs.png,bit_sequence_payload-12-10.txt,12,491,240,182,58,121.059818
yagate_gs.png,bit_sequence_payload-12-11.txt,12,491,222,187,35,164.4214575
yagate_gs.png,bit_sequence_payload-12-12.txt,12,491,215,188,27,206.5595579
yagate_gs.png,bit_sequence_payload-12-13.txt,12,491,212,185,27,140.3749769
yagate_gs.png,bit_sequence_payload-12-14.txt,12,491,240,183,57,160.424521
yagate_gs.png,bit_sequence_payload-12-15.txt,12,491,246,188,58,319.5388174
yagate_gs.png,bit_sequence_payload-12-16.txt,12,491,233,188,45,342.3477333
yagate_gs.png,bit_sequence_payload-12-17.txt,12,491,236,180,56,290.8118224
yagate_gs.png,bit_sequence_payload-12-18.txt,12,491,244,187,57,368.4317005
yagate_gs.png,bit_sequence_payload-12-19.txt,12,491,235,185,50,176.8810329
yagate_gs.png,bit_sequence_payload-12-2.txt,12,491,232,185,47,155.9366417
yagate_gs.png,bit_sequence_payload-12-3.txt,12,491,255,189,66,185.7058561
yagate_gs.png,bit_sequence_payload-12-4.txt,12,491,237,187,50,188.5533907
yagate_gs.png,bit_sequence_payload-12-5.txt,12,491,237,180,57,123.2279022
yagate_gs.png,bit_sequence_payload-12-6.txt,12,491,245,189,56,195.1201708
yagate_gs.png,bit_sequence_payload-12-7.txt,12,491,230,178,52,128.203969
yagate_gs.png,bit_sequence_payload-12-8.txt,12,491,232,185,47,141.3498902
yagate_gs.png,bit_sequence_payload-12-9.txt,12,491,243,182,61,109.2931664
yagate_gs.png,bit_sequence_payload-13-0.txt,13,532,260,209,51,345.8289378
yagate_gs.png,bit_sequence_payload-13-1.txt,13,532,246,203,43,193.222584
yagate_gs.png,bit_sequence_payload-13-10.txt,13,532,265,210,55,375.3618524
yagate_gs.png,bit_sequence_payload-13-11.txt,13,532,262,203,59,268.8984082
yagate_gs.png,bit_sequence_payload-13-12.txt,13,532,261,204,57,242.518949
yagate_gs.png,bit_sequence_payload-13-13.txt,13,532,276,211,65,343.7383029
yagate_gs.png,bit_sequence_payload-13-14.txt,13,532,258,203,55,222.9958279
yagate_gs.png,bit_sequence_payload-13-15.txt,13,532,262,203,59,230.3184805
yagate_gs.png,bit_sequence_payload-13-16.txt,13,532,257,202,55,240.2518158
yagate_gs.png,bit_sequence_payload-13-17.txt,13,532,248,207,41,386.2149642
yagate_gs.png,bit_sequence_payload-13-18.txt,13,532,269,204,65,245.2377102
yagate_gs.png,bit_sequence_payload-13-19.txt,13,532,258,201,57,243.6527596
yagate_gs.png,bit_sequence_payload-13-2.txt,13,532,251,206,45,358.3122087
yagate_gs.png,bit_sequence_payload-13-3.txt,13,532,265,206,59,332.0510328
yagate_gs.png,bit_sequence_payload-13-4.txt,13,532,292,203,89,249.0240393
yagate_gs.png,bit_sequence_payload-13-5.txt,13,532,275,210,65,406.5293171
yagate_gs.png,bit_sequence_payload-13-6.txt,13,532,265,200,65,220.8593924
yagate_gs.png,bit_sequence_payload-13-7.txt,13,532,259,208,51,407.2475665
yagate_gs.png,bit_sequence_payload-13-8.txt,13,532,264,205,59,287.1482649
yagate_gs.png,bit_sequence_payload-13-9.txt,13,532,255,204,51,256.2737131
yagate_gs.png,bit_sequence_payload-14-0.txt,14,573,257,204,53,316.2953296
yagate_gs.png,bit_sequence_payload-14-1.txt,14,573,263,204,59,263.4204385
yagate_gs.png,bit_sequence_payload-14-2.txt,14,573,267,206,61,352.7507052
yagate_gs.png,bit_sequence_payload-14-3.txt,14,573,251,204,47,365.1580105
yagate_gs.png,bit_sequence_payload-14-4.txt,14,573,275,204,71,491.7412171
yagate_gs.png,bit_sequence_payload-14-5.txt,14,573,260,203,57,253.2084758
yagate_gs.png,bit_sequence_payload-14-6.txt,14,573,266,205,61,283.6914566
yagate_gs.png,bit_sequence_payload-14-7.txt,14,573,268,207,61,330.1485391
yagate_gs.png,bit_sequence_payload-15-0.txt,15,614,291,222,69,403.7352455
yagate_gs.png,bit_sequence_payload-15-1.txt,15,614,285,224,61,537.9161706
yagate_gs.png,bit_sequence_payload-15-10.txt,15,614,294,221,73,479.6258895
yagate_gs.png,bit_sequence_payload-15-11.txt,15,614,291,224,67,519.9366605
yagate_gs.png,bit_sequence_payload-15-12.txt,15,614,270,222,48,537.390265
yagate_gs.png,bit_sequence_payload-15-13.txt,15,614,278,222,56,505.0854568
yagate_gs.png,bit_sequence_payload-15-14.txt,15,614,280,227,53,556.7481012
yagate_gs.png,bit_sequence_payload-15-15.txt,15,614,277,222,55,558.7022293
yagate_gs.png,bit_sequence_payload-15-16.txt,15,614,278,220,58,428.9519792
yagate_gs.png,bit_sequence_payload-15-17.txt,15,614,292,215,77,279.4709756
yagate_gs.png,bit_sequence_payload-15-18.txt,15,614,272,226,46,690.4249833
yagate_gs.png,bit_sequence_payload-15-19.txt,15,614,308,226,82,691.3213727
yagate_gs.png,bit_sequence_payload-15-2.txt,15,614,279,223,56,415.7063036
yagate_gs.png,bit_sequence_payload-15-3.txt,15,614,293,223,70,382.9646423
yagate_gs.png,bit_sequence_payload-15-4.txt,15,614,305,218,87,454.5760212
yagate_gs.png,bit_sequence_payload-15-5.txt,15,614,290,214,76,296.2989142
yagate_gs.png,bit_sequence_payload-15-6.txt,15,614,288,228,60,958.5470395
yagate_gs.png,bit_sequence_payload-15-7.txt,15,614,303,223,80,601.055234
yagate_gs.png,bit_sequence_payload-15-8.txt,15,614,297,228,69,578.6326315
yagate_gs.png,bit_sequence_payload-15-9.txt,15,614,256,223,33,565.0471091
yagate_gs.png,bit_sequence_payload-16-0.txt,16,655,311,244,67,1350.730804
yagate_gs.png,bit_sequence_payload-16-1.txt,16,655,321,248,73,2068.500439
yagate_gs.png,bit_sequence_payload-16-10.txt,16,655,315,240,75,754.2264473
yagate_gs.png,bit_sequence_payload-16-11.txt,16,655,329,244,85,1363.116166
yagate_gs.png,bit_sequence_payload-16-12.txt,16,655,320,237,83,477.9325161
yagate_gs.png,bit_sequence_payload-16-13.txt,16,655,304,239,65,791.1316538
yagate_gs.png,bit_sequence_payload-16-14.txt,16,655,314,241,73,709.362545
yagate_gs.png,bit_sequence_payload-16-15.txt,16,655,314,241,73,614.8286352
yagate_gs.png,bit_sequence_payload-16-2.txt,16,655,315,244,71,1353.27028
yagate_gs.png,bit_sequence_payload-16-3.txt,16,655,318,243,75,822.2174692
yagate_gs.png,bit_sequence_payload-16-4.txt,16,655,318,249,69,1187.364144
yagate_gs.png,bit_sequence_payload-16-5.txt,16,655,302,241,61,722.0435557
yagate_gs.png,bit_sequence_payload-16-6.txt,16,655,322,237,85,501.7281065
yagate_gs.png,bit_sequence_payload-16-7.txt,16,655,313,236,77,659.607559
yagate_gs.png,bit_sequence_payload-16-8.txt,16,655,302,241,61,791.7619195
yagate_gs.png,bit_sequence_payload-16-9.txt,16,655,304,247,57,896.5337737
yagate_gs.png,bit_sequence_payload-17-0.txt,17,696,344,271,73,2894.915688
yagate_gs.png,bit_sequence_payload-18-0.txt,18,737,348,290,58,4395.007425
yagate_gs.png,bit_sequence_payload-19-0.txt,19,778,367,295,72,12689.71569
yagate_gs.png,bit_sequence_payload-19-1.txt,19,778,358,284,74,2696.299506
yagate_gs.png,bit_sequence_payload-19-2.txt,19,778,385,281,104,2995.688936
yagate_gs.png,bit_sequence_payload-19-3.txt,19,778,361,287,74,9560.192098
yagate_gs.png,bit_sequence_payload-19-4.txt,19,778,373,289,84,9611.366127
yagate_gs.png,bit_sequence_payload-20-0.txt,20,819,416,307,109,3985.35225
yagate_gs.png,bit_sequence_payload-21-0.txt,21,860,414,328,86,11297.25296
